F 200,135,25
C 010,150, 200

NO textures/gato.png
SO textures/cal_paj.png
WE textures/lemur.png
EA textures/calamardo.png

111111111111111111111
100000000000000000001
100000000000000000001
100000011111000000001
10000001   1000000001
10000001   1000000001
10000001   1000000001
100000011111000000001
100000000000000000001
100000000000000000001
111111111111111011111