F 200,135,25
C 010,150, 200

NO textures/gato.png
SO textures/gato.png
WE textures/gato.png
EA textures/calamardo.png

111111111111111
1110000000000001
110000111111110111
10001      10011N
10000111111110111
100000000000001
1111111111111111