F 200,135,25
C 010,150, 200

NO textures/gato.png
SO textures/cal_paj.png
WE textures/lemur.png
EA textures/calamardo.png

111111111111111
110000000000001
110000111111110111
10001      10011
10000111111110111
101000000000001
11N1111111111111