F 0, 0, 255
C 0, 255, 0

NO textures/north_wall.png
SO textures/south_wall.png
WE textures/west_wall.png
EA textures/east_wall.png


 11111111111111111111111
 11110000001111000000001111
    10000000000001000000001    11111
111110000000000111000000001    10001
111001110000011111111111111    11111
10000000000001
1000N001111001
1111111   1111