     
11111111111111111111111
10000000011110000000001    11111
10000000000000000000001    10001   1
10000000000000000000001    10001
11111111000001111111111    11111
11111111000001
       100N001
       1111111