F 0, 0, 255
C 0, 255, 120

NO textures/north_wall.png
SO textures/south_wall.png
WE textures/west_wall.png
EA textures/east_wall.png


 11111111111111111111111
 1111000000111100000000111
    10000000000001000000001    11111
111110000000000111000000001    10001
111001110000011111111111101    11111
10000000000001          101
10000011110001          101
100N00011100011111111111101
100000011100000000000000001
1111111   1111111111111111
