F 139,99,58
C 200,154,25

NO textures/bookshelf.xpm
SO textures/bookshelf_01.xpm
WE textures/bookshelf_02.xpm
EA textures/bookshelf_03.xpm


11111111111111111111111
11110000001111000000001
10000000000001000000001    11111
10000000000001000000001    10001
11111111000001111111111    11111
11111111000001
1000S001111001
1111111   1111