F 139,99,58
C 171,154,137

NO textures/bookshelf.xpm
SO textures/bookshelf_01.xpm
WE textures/bookshelf_02.xpm
EA textures/bookshelf_03.xpm

 
 11111111111111111111111
 111100000011110000000001    
 100000000000000000000011    
 10000000000000000000001    
 11111111000001111111111    
 11111111000001
       100N001
       1111111
       111

           
    111