F 139,99,58
C 200,154,25

NO textures/test.xpm
SO textures/test.xpm
WE textures/test.xpm
EA textures/test.xpm


11111111111111111111111
11110000001111000000001
10000000000001000000001    11111
10000000000001000000001    10001
11100111000001111111111    11111
10000000000001
1000N001111001
1111111   1111