F 200,135,25
C 010,150, 200

NO textures/gato.png
SO textures/cal_paj.png
WE textures/lemur.png
EA textures/calamardo.png

1111111111111111111111111111
1000000000000000000000000001
1000000000000000000000000001
1000000001111111100000000001
1000000001      100000000001
1000000001      100000000001
1000000001      100000000001
1000000001111111100000000001
1000000000000000000000000001
100000000000N000000000000001
1111111111111111111111111111